90p44p
00000000000000000000000000000000000000000000
00000000000001111111000011100000000000000000
00007000000001111111000177100000000000000000
00000000000000111111100011100000000000000000
00000000004444444111000000000000000000000000
00000000044222224410000000000000000000000000
00000000042222222400000000000000000000000000
00000000042222222400000000000000000000000000
00000000042222222400000000000000000000000000
00000000044222224400000000000000000000000000
00000000004422244100000000000000000000000000
00000000000000000000000000000000000000000000
00000000000000000000000010000000000000000000
00000001111000000000000171000000000000000000
00000011771100000000000010000000000000000000
00000001771000000000000000000000000000000000
00000000110000000000000000000000000000000000
00000000000000000000000000000000000000000000
00000000000000000000000000000000000000000000
00003333000000000000000000000011111000000000
33333333333000000000000000000117711100000000
33333303333300000000000000000117711100000000
00000000003333000000000000000011111000000000
00000000000333300000000000000000000000000000
00000000000003300033000000000000000000000000
00000000000000000033300000000000000000000000
00000000000000000333333330000000000333300000
00000000000000000003333333333003333333333333
00000000111111000000000333333333333333333333
00000011111100000000000000033333330000000000
00000000001111100000000000000000000000000000
00000000000000000000000000000000000000000000
00000000000000000000000000000000011100000000
00000000000000000000000000000000111111000000
00000000000000000000000000000011117111000000
00000000000000000000000000000011177711100000
00000000000000000000000000000001117111100000
00000111110000000000000000000000111111000000
00111111111000000000022200000000000000000000
11111111000000000002222222000000000000000000
11111112222000000022222222200000000000000000
11111112222000000422222222244444444444000000
11111144224442000422222222242222662222400000
11100422222240000422222222242222662222240000
10004662222240000422222222242222222222240000
00004662222244224422222222242222222222240000
00004222222222222222222222222222222222240000
00000422222222222222222222222222222222400000
00000044444442222222222222244444444444000000
00000000000042222222222222242224222240000000
00000000000042222222222222242222222240000000
00000000044442222444444422244224444444400000
00000000042222222222222422222222222222240000
00000000042222222222222422222222222222224000
00000000042222222444444422222222222222222400
00000000042222222222222422222222222222222400
00000000042222222222222400044444422222222400
00000000042222222222224000000000042222224000
00000000004222222222240000000000004222240000
00000000000444444444400000000000000444400000
00000000000000000000000000000000000000000000
00000000000000000000000000000000000000000000
00000000000000000000000000000000000000000000
00000000000000000000000000000000000000000000
00000000000000000000000000000000000000000000
00000000000000000000000000000000000000000000
00000001100000000000000000000000000000000000
00000111111000000000000000000000000000000000
00000117711000000000000000000000000000000000
00001117711000000000000000000000000000000000
00011111110000000000000000000000000000000000
00000011100000000000000000000000000000000000
00000000000000000000000000000000000000000000
00000000000000000000000000000000000000000000
00000000000000000000000000000000000000000000
00000000000000000000000000000000000000000000
00000000000000000000000000000000000000000000
00000000000000000000000000000000000000000000
00000000000000000000000000000000000000000000
00000000000000000000000000000000000000000000
00000000000000000000000000000000000000000000
00000000000000000000000000000000000000000000
00000000000000000000000000000000000000000000
00000000000000000000000000000000000000000000
00000000000000000000000000000000000000000000
00000000000000000000000000000000000011100000
00000000000000000000000000000000000017100000
00000000000000000000000000000000000011000000
00000000000000000000000000000000000000000000